0000000000000000010000000010000000010000
0000000000001000000100010000000000000000
0000000000010010000000010000000000010000
0000000100010000000000000000100100000010
0100100010000000001000000010000000000000
0000000000000001000000000000000000000000
1000000100100000000010010000001000000010
0000000000000010000000000001000001000000
0010000001000011000000000000000000000000
1000000000000000010000000000101000000000
0000000100000010000001000000000000001000
0000100001000000000000000000000000000000
0000000000000000000000000100000100000001
0010000000010001000100000000100000001000
1000000000000000000000000000000000000000
0000100000000000000001001000000000000000
0000000011000000000100000000100000000000
1000000000001000000000000000000001001000
0010000000000000000000000000000000000010
0000000100000001000000000100000000000000
1000000000000000000000100000010000000000
0000000000000000000000000000000000100010
0001001000000010000100000000010000000100
0000000000100000000000000100000010000000