2200000000000000000000000000000000000000
0000000000000000000000000000000000000000
0000111111111111111001111111111111110000
0000100000000000000000000000000000010000
0000100000000000000000000000000000010000
0000100111111111111001111111111110010000
0000100100000000000000000000000010010000
0000100100000000000000000000000010010000
0000100100111111111001111111110010010000
0000100100100000000000000000010010010000
0000100100100000000000000000010010010000
0000000000000111111111111110000000000000
0000000000000111111111111110000000000000
0000100100100000000000000000010010010000
0000100100100000000000000000010010010000
0000100100111111111001111111110010010000
0000100100000000000000000000000010010000
0000100100000000000000000000000010010000
0000100111111111111001111111111110010000
0000100000000000000000000000000000010000
0000100000000000000000000000000000010000
0000111111111111111001111111111111110000
0000000000000000000000000000000000000000
2200000000000000000000000000000000000000
