2222220111111111111111111111111111100000
1111110000111111111100111111111111101111
1000010000011111111000010011111011001111
1000001000011111110000010001110000001111
1000001000011111100000010001110000001111
1000000100001111000000011001100000000111
1001000010001100000000011001100000000111
1001110010000000000000000001100000001111
1001001110000000000000000011000000011111
1001000110000111000000100011000000001111
1001000110000101100000100000000000001111
1001000110001100110001100000000000001111
1001100000011000011111000000000000001111
1000110000011000001110000000000000001111
1100011000001110000000000000000000011111
1100001100001100000000000000000000011111
1110000000001000011100000000000000111111
1111110000011100011100000000001011111111
1111111100111110001100000000001111111111
1111000001111110001110000000011111111111
1111000011111111000111100001111111111111
1110011111111111100011100111111111111111
1110011111111111100011111111111111111111
2200111111111111111111111111111111111111